1111111111111111111111111111111111111111111
1111111111111111111111111111111111111111111
1110000000000000000C00C00000000000000000111
11100P00000C0011101111111000000000000000111
1110011111111110000000001110000000000000111
111000000000000000000C000000000000000000111
1110000000000000001111111111110000000000111
1110000000000000000000000000000E00000000111
1110000000000000000000000000111111000000111
1110000000000000000000000000000000011000111
1110000000000000000000000000000000000000111
1111111111111111111111111111111111111111111
1111111111111111111111111111111111111111111
