1111111111111
10010000C0CC1
1000011111001
1P0111E000001
1110111111111